Geo_FIPS,Geo_NAME,Geo_GEOID,Geo_AREALAND,Geo_AREAWATR,SE_T001_001,SE_T002_001,SE_T002_002,SE_T002_003,SE_T128_001,SE_T128_002,SE_T128_009,SE_T128_010,SE_T128_003,SE_T128_004,SE_T128_005,SE_T128_006,SE_T128_007,SE_T128_008,SE_T129_001,SE_T129_002,SE_T129_003,SE_T129_004,SE_T129_005,SE_T129_006,SE_T129_007,SE_T129_008,SE_T129_009,SE_T129_010
53033000100,"Census Tract 1, King County, Washington",14000US53033000100,1910585,1486352,6918,6918,9378.037,0.737681024,3448,2467,2067,400,685,0,83,86,5,122,3448,3326,197,764,945,766,405,162,87,122
53033000200,"Census Tract 2, King County, Washington",14000US53033000200,3286319,0,7974,7974,6284.406,1.268854914,4007,2873,2415,458,699,0,129,61,0,245,4007,3762,88,896,854,904,762,183,75,245
53033000300,"Census Tract 3, King County, Washington",14000US53033000300,1210516,0,2637,2637,5642.055,0.46738286,1403,960,735,225,309,0,0,78,14,42,1403,1361,82,237,302,351,186,140,63,42
53033000401,"Census Tract 4.01, King County, Washington",14000US53033000401,1281899,81874,5907,5907,11934.68,0.494943992,2691,1976,1681,295,385,0,19,229,19,63,2691,2628,274,464,833,421,397,206,33,63
53033000402,"Census Tract 4.02, King County, Washington",14000US53033000402,1798936,0,4906,4906,7063.332,0.694573102,2644,1838,1458,380,406,23,86,0,15,276,2644,2368,135,525,505,457,727,19,0,276
53033000500,"Census Tract 5, King County, Washington",14000US53033000500,2882910,932456,3044,3044,2734.71,1.113097821,1537,1239,1066,173,148,0,0,0,42,108,1537,1429,48,276,371,418,242,57,17,108
53033000600,"Census Tract 6, King County, Washington",14000US53033000600,3783740,54223,7674,7674,5252.89,1.460910244,4272,3091,2561,530,788,40,23,89,0,241,4272,4031,274,985,987,872,556,196,161,241
53033000700,"Census Tract 7, King County, Washington",14000US53033000700,1294675,0,4892,4892,9786.411,0.499876833,2768,1869,1590,279,765,14,28,59,0,33,2768,2735,125,615,582,617,419,242,135,33
53033000800,"Census Tract 8, King County, Washington",14000US53033000800,1141587,0,2487,2487,5642.409,0.440769224,1376,991,831,160,228,9,17,10,9,112,1376,1264,86,226,243,299,304,59,47,112
53033000900,"Census Tract 9, King County, Washington",14000US53033000900,996458,2531309,1971,1971,5123.012,0.384734601,1067,784,682,102,161,14,43,10,4,51,1067,1016,37,209,267,305,130,68,0,51
53033001000,"Census Tract 10, King County, Washington",14000US53033001000,954457,0,2094,2094,5682.22,0.368517924,966,510,395,115,233,0,22,39,0,162,966,804,44,128,220,183,149,71,9,162
53033001100,"Census Tract 11, King County, Washington",14000US53033001100,1060418,0,2669,2669,6518.824,0.409429696,1497,933,843,90,333,0,71,39,36,85,1497,1412,171,170,401,308,176,150,36,85
53033001200,"Census Tract 12, King County, Washington",14000US53033001200,1834052,0,6556,6556,9258.168,0.708131466,3219,1845,1527,318,835,15,15,238,58,213,3219,3006,268,574,769,772,370,171,82,213
53033001300,"Census Tract 13, King County, Washington",14000US53033001300,1183989,0,4389,4389,9600.982,0.457140728,2782,1944,1289,655,526,29,131,31,0,121,2782,2661,43,847,634,703,238,146,50,121
53033001400,"Census Tract 14, King County, Washington",14000US53033001400,2137298,211433,5505,5505,6670.985,0.825215406,3301,2605,2273,332,462,0,27,30,0,177,3301,3124,96,756,781,576,613,157,145,177
53033001500,"Census Tract 15, King County, Washington",14000US53033001500,1170487,398486,2398,2398,5306.16,0.451927576,1278,951,851,100,164,7,47,11,0,98,1278,1180,82,242,307,273,258,18,0,98
53033001600,"Census Tract 16, King County, Washington",14000US53033001600,2041021,457717,4111,4111,5216.723,0.788042647,2184,1645,1440,205,298,0,47,49,14,131,2184,2053,188,307,572,524,371,84,7,131
53033001701,"Census Tract 17.01, King County, Washington",14000US53033001701,892771,0,4055,4055,11763.82,0.344700825,2626,1716,1493,223,540,13,114,105,9,129,2626,2497,197,715,478,439,550,91,27,129
53033001702,"Census Tract 17.02, King County, Washington",14000US53033001702,1280222,0,4408,4408,8917.725,0.494296499,2540,1587,1379,208,744,7,52,67,0,83,2540,2457,39,375,708,569,546,168,52,83
53033001800,"Census Tract 18, King County, Washington",14000US53033001800,942974,0,5217,5217,14329.1,0.364084312,3628,2438,1961,477,822,0,43,219,29,77,3628,3551,132,848,965,865,558,138,45,77
53033001900,"Census Tract 19, King County, Washington",14000US53033001900,1663251,0,4723,4723,7354.581,0.642184829,2547,1697,1494,203,498,24,121,90,0,117,2547,2430,216,602,758,411,356,67,20,117
53033002000,"Census Tract 20, King County, Washington",14000US53033002000,1103292,28680,3600,3600,8451.033,0.425983441,2171,1473,1175,298,307,11,169,52,8,151,2171,2020,79,672,588,380,195,82,24,151
53033002100,"Census Tract 21, King County, Washington",14000US53033002100,1365467,0,4148,4148,7867.836,0.527209779,2442,1782,1450,332,372,27,118,34,18,91,2442,2351,184,646,599,493,330,90,9,91
53033002200,"Census Tract 22, King County, Washington",14000US53033002200,2767963,1488647,5622,5622,5260.516,1.068716535,2755,1888,1627,261,437,33,171,17,0,209,2755,2546,127,607,733,583,441,55,0,209
53033002400,"Census Tract 24, King County, Washington",14000US53033002400,978103,0,2994,2994,7928.024,0.377647696,1696,1193,992,201,297,8,52,60,0,86,1696,1610,152,437,334,391,210,50,36,86
53033002500,"Census Tract 25, King County, Washington",14000US53033002500,984333,0,2981,2981,7843.641,0.380053112,1712,1034,825,209,319,36,122,65,0,136,1712,1576,36,505,428,281,262,50,14,136
53033002600,"Census Tract 26, King County, Washington",14000US53033002600,1216657,28175,4989,4989,10620.45,0.469753914,2904,1706,1497,209,650,9,136,62,35,306,2904,2598,180,780,695,559,303,74,7,306
53033002700,"Census Tract 27, King County, Washington",14000US53033002700,1593775,0,6027,6027,9794.267,0.615359994,3609,2196,1950,246,870,0,156,71,0,316,3609,3293,222,687,764,1099,421,42,58,316
53033002800,"Census Tract 28, King County, Washington",14000US53033002800,983387,0,4727,4727,12449.7,0.37968786,2901,1523,1333,190,641,22,188,136,13,378,2901,2523,71,430,513,768,562,151,28,378
53033002900,"Census Tract 29, King County, Washington",14000US53033002900,986207,0,4303,4303,11300.59,0.380776668,2608,1589,1420,169,451,38,182,171,24,153,2608,2455,218,563,467,734,377,96,0,153
53033003000,"Census Tract 30, King County, Washington",14000US53033003000,1493249,0,5719,5719,9919.405,0.576546687,3384,2147,1641,506,600,15,233,54,0,335,3384,3049,247,734,666,705,523,125,49,335
53033003100,"Census Tract 31, King County, Washington",14000US53033003100,2232860,465516,6223,6223,7218.319,0.862112102,3507,2405,2082,323,592,0,103,89,12,306,3507,3201,326,551,531,916,616,173,88,306
53033003200,"Census Tract 32, King County, Washington",14000US53033003200,2475044,1014738,8233,8233,8615.351,0.955619872,4989,2885,2520,365,848,49,339,215,52,601,4989,4388,390,808,875,942,1037,174,162,601
53033003300,"Census Tract 33, King County, Washington",14000US53033003300,1296368,0,6572,6572,13130.07,0.500530504,4539,2756,2409,347,800,55,430,122,94,282,4539,4257,285,911,1202,1003,621,190,45,282
53033003400,"Census Tract 34, King County, Washington",14000US53033003400,787147,0,3587,3587,11802.48,0.303919169,2061,1244,1133,111,256,18,166,177,10,190,2061,1871,87,449,595,482,165,57,36,190
53033003500,"Census Tract 35, King County, Washington",14000US53033003500,1284761,0,3960,3960,7983.082,0.496049016,2415,1410,1156,254,451,42,149,42,13,308,2415,2107,89,527,504,583,295,91,18,308
53033003600,"Census Tract 36, King County, Washington",14000US53033003600,1196463,0,6122,6122,13252.32,0.461956967,4151,2078,1894,184,1215,0,301,184,50,323,4151,3828,351,876,913,997,467,144,80,323
53033003800,"Census Tract 38, King County, Washington",14000US53033003800,624606,0,2165,2165,8977.378,0.241161735,1099,674,576,98,209,0,77,116,4,19,1099,1080,148,252,272,231,147,21,9,19
53033003900,"Census Tract 39, King County, Washington",14000US53033003900,973807,0,3080,3080,8191.729,0.375989001,1556,1116,1041,75,118,11,93,57,61,100,1556,1456,182,311,427,322,156,28,30,100
53033004000,"Census Tract 40, King County, Washington",14000US53033004000,2606984,3881765,3125,3125,3104.627,1.006562193,1564,1045,934,111,251,0,83,98,0,87,1564,1477,98,438,412,228,236,49,16,87
53033004100,"Census Tract 41, King County, Washington",14000US53033004100,3267563,5654701,7868,7868,6236.46,1.261613181,3728,2653,2281,372,385,0,147,203,0,340,3728,3388,486,1006,818,592,289,166,31,340
53033004200,"Census Tract 42, King County, Washington",14000US53033004200,2464009,0,8176,8176,8594.02,0.951359234,4583,2733,2266,467,648,26,460,327,68,321,4583,4262,395,1159,1015,968,630,57,38,321
53033004301,"Census Tract 43.01, King County, Washington",14000US53033004301,979359,0,3548,3548,9382.951,0.37813264,1860,1047,929,118,414,15,118,141,0,125,1860,1735,104,501,526,355,154,75,20,125
53033004302,"Census Tract 43.02, King County, Washington",14000US53033004302,330714,0,3703,3703,29000.06,0.127689395,1529,529,414,115,381,30,143,330,14,102,1529,1427,184,438,302,308,78,56,61,102
53033004400,"Census Tract 44, King County, Washington",14000US53033004400,989908,0,6607,6607,17286.51,0.382205632,4365,1676,1549,127,1163,15,499,827,64,121,4365,4244,319,1104,1130,998,343,179,171,121
53033004500,"Census Tract 45, King County, Washington",14000US53033004500,671000,0,3052,3052,11780.39,0.259074559,1974,848,751,97,575,0,190,182,31,148,1974,1826,172,513,371,519,203,48,0,148
53033004600,"Census Tract 46, King County, Washington",14000US53033004600,1552357,1033231,3464,3464,5779.417,0.599368414,2126,1335,1217,118,341,9,92,45,32,272,2126,1854,185,497,479,475,176,42,0,272
53033004700,"Census Tract 47, King County, Washington",14000US53033004700,1950914,353088,8395,8395,11145.01,0.753252139,5833,3395,2814,581,1294,0,229,534,69,312,5833,5521,476,1192,1324,1491,733,261,44,312
53033004800,"Census Tract 48, King County, Washington",14000US53033004800,1318565,41555,4772,4772,9373.389,0.509100814,3327,1923,1619,304,714,89,261,83,0,257,3327,3070,230,833,777,767,324,95,44,257
53033004900,"Census Tract 49, King County, Washington",14000US53033004900,1085823,25325,6923,6923,16513.27,0.419238622,5308,2772,2538,234,1734,22,270,265,24,221,5308,5087,383,1540,1273,968,788,135,0,221
53033005000,"Census Tract 50, King County, Washington",14000US53033005000,757380,0,3695,3695,12635.67,0.292426065,2536,1386,1199,187,678,10,146,164,7,145,2536,2391,130,625,620,728,239,42,7,145
53033005100,"Census Tract 51, King County, Washington",14000US53033005100,881711,0,3726,3726,10944.96,0.340430535,2343,1344,1116,228,386,17,113,245,18,220,2343,2123,220,656,522,537,165,23,0,220
53033005200,"Census Tract 52, King County, Washington",14000US53033005200,964721,85584,6644,6644,17837.16,0.372480876,3769,1474,1174,300,1042,0,187,841,15,210,3769,3559,143,1063,1250,624,364,115,0,210
53033005301,"Census Tract 53.01, King County, Washington",14000US53033005301,543485,0,7377,7377,35155.23,0.209840741,3027,669,615,54,1058,4,96,856,10,334,3027,2693,211,757,645,676,230,92,82,334
53033005302,"Census Tract 53.02, King County, Washington",14000US53033005302,2511567,745303,5178,5178,5339.678,0.969721481,1159,153,111,42,225,0,8,240,10,523,1159,636,95,299,104,65,22,51,0,523
53033005400,"Census Tract 54, King County, Washington",14000US53033005400,1199275,647090,5022,5022,10845.65,0.463042686,3753,1874,1672,202,867,15,341,340,0,316,3753,3437,308,1079,857,704,359,130,0,316
53033005600,"Census Tract 56, King County, Washington",14000US53033005600,3032928,1587292,6424,6424,5485.815,1.171020097,3004,2293,2106,187,315,0,98,50,13,235,3004,2769,94,602,737,714,482,90,50,235
53033005700,"Census Tract 57, King County, Washington",14000US53033005700,5107335,2295838,6633,6633,3363.67,1.971953152,3466,2418,2042,376,528,17,227,180,12,84,3466,3382,303,798,806,593,517,338,27,84
53033005801,"Census Tract 58.01, King County, Washington",14000US53033005801,1779677,301744,5212,5212,7585.094,0.68713716,3404,2359,2036,323,618,41,96,107,37,146,3404,3258,414,1113,620,510,396,136,69,146
53033005802,"Census Tract 58.02, King County, Washington",14000US53033005802,3091582,1156787,5216,5216,4369.729,1.193666534,3631,2258,2037,221,612,65,153,109,11,423,3631,3208,363,610,953,651,535,80,16,423
53033005900,"Census Tract 59, King County, Washington",14000US53033005900,1806158,173889,7705,7705,11048.79,0.697361532,4600,2991,2500,491,326,20,181,541,56,485,4600,4115,632,1396,935,788,281,58,25,485
53033006000,"Census Tract 60, King County, Washington",14000US53033006000,1349233,150279,5564,5564,10680.66,0.520941796,3871,2192,2125,67,921,24,62,125,108,439,3871,3432,332,989,900,596,489,66,60,439
53033006100,"Census Tract 61, King County, Washington",14000US53033006100,1241431,644264,5219,5219,10888.36,0.479319209,3805,2303,2029,274,781,13,381,217,0,110,3805,3695,251,1188,1102,624,329,143,58,110
53033006200,"Census Tract 62, King County, Washington",14000US53033006200,2730880,285632,4063,4063,3853.381,1.054398708,2181,1110,972,138,455,19,171,113,10,303,2181,1878,114,761,483,349,146,8,17,303
53033006300,"Census Tract 63, King County, Washington",14000US53033006300,2306076,3491020,4988,4988,5602.097,0.890380959,2382,1604,1457,147,258,0,40,133,8,339,2382,2043,60,587,706,497,158,27,8,339
53033006400,"Census Tract 64, King County, Washington",14000US53033006400,903649,0,3341,3341,9575.786,0.348900844,1907,1201,1048,153,284,36,83,40,0,263,1907,1644,146,576,384,339,157,26,16,263
53033006500,"Census Tract 65, King County, Washington",14000US53033006500,1147621,0,4449,4449,10040.65,0.443098964,2933,1515,1403,112,500,0,184,459,0,275,2933,2658,285,708,755,622,200,87,1,275
53033006600,"Census Tract 66, King County, Washington",14000US53033006600,1113996,826398,3585,3585,8334.955,0.430116279,2833,1523,1366,157,742,19,122,264,15,148,2833,2685,102,719,946,598,288,17,15,148
53033006700,"Census Tract 67, King County, Washington",14000US53033006700,1278220,102394,7600,7600,15399.47,0.493523522,5468,2484,2199,285,1161,33,194,1137,49,410,5468,5058,286,1774,1212,1137,426,223,0,410
53033006800,"Census Tract 68, King County, Washington",14000US53033006800,718106,0,3206,3206,11563.06,0.277262288,1882,1098,999,99,277,30,26,194,23,234,1882,1648,242,459,348,350,160,89,0,234
53033006900,"Census Tract 69, King County, Washington",14000US53033006900,902889,0,4727,4727,13559.67,0.348607407,2719,1799,1609,190,451,0,83,138,17,231,2719,2488,266,757,503,589,348,25,0,231
53033007000,"Census Tract 70, King County, Washington",14000US53033007000,805962,0,7503,7503,24111.16,0.311183681,5278,2458,2146,312,1489,0,144,870,52,265,5278,5013,582,1684,1175,1134,325,49,64,265
53033007100,"Census Tract 71, King County, Washington",14000US53033007100,862095,0,3780,3780,11356.24,0.332856755,2926,1290,1147,143,694,16,22,675,0,229,2926,2697,117,926,680,459,393,68,54,229
53033007200,"Census Tract 72, King County, Washington",14000US53033007200,1010266,0,6798,6798,17427.82,0.3900659,5300,1399,1153,246,1216,0,33,2351,89,212,5300,5088,560,2076,881,777,594,200,0,212
53033007300,"Census Tract 73, King County, Washington",14000US53033007300,926047,0,5594,5594,15645.42,0.357548761,3329,1129,885,244,483,0,54,1486,53,124,3329,3205,748,1216,415,485,209,89,43,124
53033007401,"Census Tract 74.01, King County, Washington",14000US53033007401,259386,0,5019,5019,50115.08,0.100149499,4084,1456,1334,122,1205,40,92,1111,0,180,4084,3904,244,1033,1070,835,541,110,71,180
53033007402,"Census Tract 74.02, King County, Washington",14000US53033007402,249282,0,5210,5210,54130.81,0.096248322,3993,1089,944,145,1137,0,156,1430,0,181,3993,3812,153,1266,1073,629,444,178,69,181
53033007500,"Census Tract 75, King County, Washington",14000US53033007500,801744,0,7783,7783,25142.54,0.309555102,5729,1869,1779,90,1613,56,197,1606,0,388,5729,5341,579,1768,1343,865,646,112,28,388
53033007600,"Census Tract 76, King County, Washington",14000US53033007600,571878,0,3871,3871,17531.44,0.22080334,2444,789,719,70,839,29,230,416,0,141,2444,2303,50,582,678,613,294,78,8,141
53033007700,"Census Tract 77, King County, Washington",14000US53033007700,1058325,0,5123,5123,12537.27,0.408621584,3177,1614,1303,311,926,0,121,222,0,294,3177,2883,166,673,780,813,262,176,13,294
53033007800,"Census Tract 78, King County, Washington",14000US53033007800,2114574,3212025,5641,5641,6909.251,0.816441621,3050,1874,1757,117,523,0,193,66,24,370,3050,2680,195,960,788,362,247,128,0,370
53033007900,"Census Tract 79, King County, Washington",14000US53033007900,698478,0,6216,6216,23049.21,0.269683875,3761,1566,1336,230,995,17,290,745,15,133,3761,3628,211,832,919,1008,473,183,2,133
53033008001,"Census Tract 80.01, King County, Washington",14000US53033008001,493763,546001,5967,5967,31299.35,0.190642968,4359,1885,1863,22,687,0,62,1280,33,412,4359,3947,403,825,973,956,700,90,0,412
53033008002,"Census Tract 80.02, King County, Washington",14000US53033008002,229060,0,3469,3469,39224.08,0.088440564,2045,652,562,90,313,0,90,752,10,228,2045,1817,149,601,399,397,172,66,33,228
53033008100,"Census Tract 81, King County, Washington",14000US53033008100,827795,368877,4435,4435,13876.14,0.31961345,2259,531,507,24,396,0,68,1103,0,161,2259,2098,335,961,284,282,144,76,16,161
53033008200,"Census Tract 82, King County, Washington",14000US53033008200,366705,0,3866,3866,27305.04,0.141585598,2402,784,661,123,436,18,14,1009,0,141,2402,2261,268,1020,293,252,238,143,47,141
53033008300,"Census Tract 83, King County, Washington",14000US53033008300,237446,0,2794,2794,30476.09,0.091678417,1984,523,462,61,346,9,8,965,6,127,1984,1857,165,622,453,231,238,101,47,127
53033008400,"Census Tract 84, King County, Washington",14000US53033008400,382615,0,4127,4127,27936.39,0.147728484,2948,641,513,128,954,0,120,1084,9,140,2948,2808,262,887,754,469,256,97,83,140
53033008500,"Census Tract 85, King County, Washington",14000US53033008500,474211,0,4311,4311,23545.29,0.183093899,1054,275,217,58,250,0,30,483,0,16,1054,1038,145,448,143,103,103,73,23,16
53033008600,"Census Tract 86, King County, Washington",14000US53033008600,711360,0,4890,4890,17803.98,0.274657643,2748,889,752,137,566,37,96,852,0,308,2748,2440,310,730,586,443,179,65,127,308
53033008700,"Census Tract 87, King County, Washington",14000US53033008700,732388,0,4440,4440,15701.44,0.2827766,2885,1355,1158,197,601,23,296,455,17,138,2885,2747,204,890,777,550,187,122,17,138
53033008800,"Census Tract 88, King County, Washington",14000US53033008800,948580,0,3867,3867,10558.4,0.366248801,2476,1013,949,64,766,0,136,391,0,170,2476,2306,153,649,570,533,275,95,31,170
53033008900,"Census Tract 89, King County, Washington",14000US53033008900,1280326,1636171,4686,4686,9479.37,0.494336653,2626,1945,1672,273,321,55,164,39,0,102,2626,2524,212,872,571,696,81,69,23,102
53033009000,"Census Tract 90, King County, Washington",14000US53033009000,820730,0,3478,3478,10975.57,0.316885638,1837,997,866,131,467,0,51,197,0,125,1837,1712,98,390,475,404,264,62,19,125
53033009100,"Census Tract 91, King County, Washington",14000US53033009100,418836,0,2693,2693,16652.91,0.161713491,1508,235,205,30,703,6,18,499,3,44,1508,1464,158,537,340,262,137,30,0,44
53033009200,"Census Tract 92, King County, Washington",14000US53033009200,330171,154864,2637,2637,20685.64,0.127479741,1300,343,309,34,430,0,29,388,0,110,1300,1190,143,394,198,239,174,34,8,110
53033009300,"Census Tract 93, King County, Washington",14000US53033009300,9429062,719984,2832,2832,777.8978,3.640581346,1707,829,664,165,445,14,37,101,21,260,1707,1447,105,445,298,336,140,58,65,260
53033009400,"Census Tract 94, King County, Washington",14000US53033009400,1723077,0,5824,5824,8754.159,0.665283777,3246,1711,1400,311,754,48,212,236,103,182,3246,3064,233,1051,811,486,385,84,14,182
53033009500,"Census Tract 95, King County, Washington",14000US53033009500,2596039,2909196,6301,6301,6286.313,1.002336304,3135,2133,1835,298,559,16,70,44,74,239,3135,2896,196,881,764,385,329,260,81,239
53033009600,"Census Tract 96, King County, Washington",14000US53033009600,1936670,1354203,5342,5342,7144.075,0.747752499,2955,2210,1900,310,361,12,79,66,24,203,2955,2752,211,776,768,554,263,170,10,203
53033009701,"Census Tract 97.01, King County, Washington",14000US53033009701,1857984,1610494,5751,5751,8016.765,0.717371663,3324,2296,1945,351,491,30,35,150,119,203,3324,3121,268,442,797,721,593,242,58,203
53033009702,"Census Tract 97.02, King County, Washington",14000US53033009702,2219066,0,5626,5626,6566.399,0.856786209,3118,2194,1953,241,491,30,60,56,13,274,3118,2844,349,343,703,868,376,170,35,274
53033009800,"Census Tract 98, King County, Washington",14000US53033009800,1930639,0,6902,6902,9259.161,0.745423917,3605,2642,2262,380,458,0,69,125,42,269,3605,3336,92,709,816,699,796,196,28,269
53033009900,"Census Tract 99, King County, Washington",14000US53033009900,6566273,2286606,5054,5054,1993.49,2.535252287,3270,2111,1876,235,758,0,167,64,0,170,3270,3100,311,716,840,762,191,259,21,170
53033010001,"Census Tract 100.01, King County, Washington",14000US53033010001,2253835,60359,4207,4207,4834.462,0.870210596,2036,1339,1083,256,413,0,80,30,24,150,2036,1886,134,449,505,416,167,134,81,150
53033010002,"Census Tract 100.02, King County, Washington",14000US53033010002,948258,0,4763,4763,13009.24,0.366124476,3008,1798,1510,288,953,8,78,82,8,81,3008,2927,226,937,552,602,415,186,9,81
53033010100,"Census Tract 101, King County, Washington",14000US53033010100,2509594,1534926,6756,6756,6972.426,0.968959702,3500,2665,2315,350,472,0,55,129,42,137,3500,3363,190,620,862,780,554,204,153,137
53033010200,"Census Tract 102, King County, Washington",14000US53033010200,2781085,1399183,4569,4569,4255.05,1.073782967,2528,1856,1663,193,314,30,37,50,12,229,2528,2299,136,278,631,605,456,156,37,229
53033010300,"Census Tract 103, King County, Washington",14000US53033010300,1660245,0,6371,6371,9938.782,0.641024206,3395,2234,1795,439,575,52,124,232,104,74,3395,3321,289,786,803,608,672,145,18,74
53033010401,"Census Tract 104.01, King County, Washington",14000US53033010401,1616864,0,4711,4711,7546.357,0.624274707,2268,1631,1414,217,402,18,38,52,11,116,2268,2152,60,569,611,521,246,134,11,116
53033010402,"Census Tract 104.02, King County, Washington",14000US53033010402,1798894,0,5218,5218,7512.704,0.694556886,2870,2130,1732,398,545,26,39,91,0,39,2870,2831,130,763,756,617,380,170,15,39
53033010500,"Census Tract 105, King County, Washington",14000US53033010500,1717929,0,6631,6631,9997.043,0.663296123,3922,2589,2243,346,790,0,88,241,63,151,3922,3771,289,654,913,1105,625,147,38,151
53033010600,"Census Tract 106, King County, Washington",14000US53033010600,2594296,817141,8079,8079,8065.584,1.001663328,4558,3059,2798,261,796,54,46,138,31,434,4558,4124,353,763,922,836,876,303,71,434
53033010701,"Census Tract 107.01, King County, Washington",14000US53033010701,1452792,3664,3700,3700,6596.234,0.560926151,1691,996,795,201,404,31,20,98,41,101,1691,1590,88,341,343,349,331,89,49,101
53033010702,"Census Tract 107.02, King County, Washington",14000US53033010702,784716,0,4393,4393,14499.28,0.302980554,1605,998,796,202,282,12,7,95,0,211,1605,1394,104,267,258,349,275,70,71,211
53033010800,"Census Tract 108, King County, Washington",14000US53033010800,4093693,330621,4670,4670,2954.604,1.580583771,2480,1824,1509,315,312,8,70,47,34,185,2480,2295,190,550,542,462,322,158,71,185
53033010900,"Census Tract 109, King County, Washington",14000US53033010900,4789752,272921,1055,1055,570.4758,1.849333665,725,404,358,46,189,5,29,55,0,43,725,682,86,154,111,208,60,33,30,43
53033011001,"Census Tract 110.01, King County, Washington",14000US53033011001,1070772,0,4932,4932,11929.54,0.413427398,1737,1286,1018,268,357,10,0,24,0,60,1737,1677,13,505,371,418,220,113,37,60
53033011002,"Census Tract 110.02, King County, Washington",14000US53033011002,1676105,0,4722,4722,7296.633,0.647147786,2074,1358,1091,267,586,0,13,14,22,81,2074,1993,74,418,505,442,321,200,33,81
53033011101,"Census Tract 111.01, King County, Washington",14000US53033011101,1150364,0,5096,5096,11473.39,0.444158042,2514,1691,1488,203,569,0,22,44,83,105,2514,2409,152,497,573,511,519,98,59,105
53033011102,"Census Tract 111.02, King County, Washington",14000US53033011102,1297471,1636998,4681,4681,9344.127,0.500956375,2345,1729,1330,399,382,0,47,59,9,119,2345,2226,194,409,471,508,466,118,60,119
53033011200,"Census Tract 112, King County, Washington",14000US53033011200,2766126,227061,4174,4174,3908.213,1.068007265,1785,1185,971,214,405,41,29,61,0,64,1785,1721,165,470,355,299,222,180,30,64
53033011300,"Census Tract 113, King County, Washington",14000US53033011300,3157555,42220,6969,6969,5716.33,1.219138853,3617,2752,2239,513,624,24,0,42,19,156,3617,3461,150,926,692,1038,355,141,159,156
53033011401,"Census Tract 114.01, King County, Washington",14000US53033011401,1233153,0,4041,4041,8487.302,0.476123055,2467,1774,1467,307,498,17,22,8,8,140,2467,2327,170,574,698,481,336,60,8,140
53033011402,"Census Tract 114.02, King County, Washington",14000US53033011402,1186185,0,4405,4405,9618.144,0.457988608,2081,1637,1348,289,287,0,14,101,0,42,2081,2039,181,362,601,335,392,111,57,42
53033011500,"Census Tract 115, King County, Washington",14000US53033011500,1538373,0,4252,4252,7158.621,0.593969161,2536,1906,1673,233,446,10,22,17,15,120,2536,2416,171,432,458,523,619,168,45,120
53033011600,"Census Tract 116, King County, Washington",14000US53033011600,3109902,971211,6570,6570,5471.626,1.200739926,3809,2825,2571,254,532,14,66,61,14,297,3809,3512,168,704,752,779,713,303,93,297
53033011700,"Census Tract 117, King County, Washington",14000US53033011700,3506091,0,5456,5456,4030.407,1.353709361,2565,1785,1470,315,578,0,8,91,64,39,2565,2526,238,555,455,654,422,131,71,39
53033011800,"Census Tract 118, King County, Washington",14000US53033011800,2301120,2269206,8010,8010,9015.524,0.888467437,2951,2282,2016,266,615,0,0,0,16,38,2951,2913,0,652,645,766,646,139,65,38
53033011900,"Census Tract 119, King County, Washington",14000US53033011900,3175666,1320016,7428,7428,6058.078,1.22613155,3786,2858,2160,698,669,33,0,0,125,101,3786,3685,75,909,625,708,749,449,170,101
53033012000,"Census Tract 120, King County, Washington",14000US53033012000,1447511,0,3474,3474,6215.924,0.558887145,2008,1490,1357,133,291,0,0,37,0,190,2008,1818,92,464,303,356,356,150,97,190
53033012100,"Census Tract 121, King County, Washington",14000US53033012100,1721295,1399504,2853,2853,4292.835,0.664595743,1569,1256,1153,103,127,15,0,0,34,137,1569,1432,120,384,373,221,268,59,7,137
53033020100,"Census Tract 201, King County, Washington",14000US53033020100,1772600,684792,3127,3127,4568.934,0.684404715,1450,1135,1064,71,132,0,10,18,0,155,1450,1295,44,233,177,393,374,67,7,155
53033020200,"Census Tract 202, King County, Washington",14000US53033020200,2592032,0,5536,5536,5531.634,1.000789193,2546,2084,2025,59,276,11,0,22,0,153,2546,2393,263,302,311,835,524,144,14,153
53033020300,"Census Tract 203, King County, Washington",14000US53033020300,2566042,36451,6823,6823,6886.671,0.990754397,3487,2368,2174,194,621,0,114,82,53,249,3487,3238,325,392,705,815,658,322,21,249
53033020401,"Census Tract 204.01, King County, Washington",14000US53033020401,2313206,0,3525,3525,3946.777,0.893133868,1879,1498,1352,146,199,7,8,46,0,121,1879,1758,87,358,526,369,292,119,7,121
53033020402,"Census Tract 204.02, King County, Washington",14000US53033020402,2786012,0,5600,5600,5205.983,1.075685293,2749,2266,1793,473,368,0,25,0,0,90,2749,2659,102,361,484,895,610,174,33,90
53033020500,"Census Tract 205, King County, Washington",14000US53033020500,2722044,0,6119,6119,5822.146,1.050987109,3404,2763,2216,547,453,0,55,50,0,83,3404,3321,207,632,608,846,677,213,138,83
53033020600,"Census Tract 206, King County, Washington",14000US53033020600,1974729,0,3612,3612,4737.377,0.762447162,1793,1372,1209,163,244,0,8,51,6,112,1793,1681,120,451,286,445,222,69,88,112
53033020700,"Census Tract 207, King County, Washington",14000US53033020700,1711193,0,3702,3702,5603.188,0.660695339,1945,1333,1152,181,398,4,0,48,35,127,1945,1818,112,443,256,346,445,186,30,127
53033020800,"Census Tract 208, King County, Washington",14000US53033020800,3160164,644499,4225,4225,3462.7,1.220146194,1986,1489,1267,222,230,0,25,24,5,213,1986,1773,137,285,353,519,353,126,0,213
53033020900,"Census Tract 209, King County, Washington",14000US53033020900,4775453,645484,3682,3682,1996.949,1.84381279,1906,1330,1165,165,280,0,9,178,11,98,1906,1808,253,288,357,276,544,67,23,98
53033021000,"Census Tract 210, King County, Washington",14000US53033021000,2618870,5753,5686,5686,5623.292,1.011151403,3094,2388,1893,495,373,0,65,67,18,183,3094,2911,252,603,786,673,324,215,58,183
53033021100,"Census Tract 211, King County, Washington",14000US53033021100,2619718,0,4531,4531,4479.58,1.011478818,2300,1725,1280,445,351,0,18,18,29,159,2300,2141,72,427,471,825,182,151,13,159
53033021300,"Census Tract 213, King County, Washington",14000US53033021300,1811833,1189300,4026,4026,5755.106,0.699552662,2087,1553,1371,182,236,0,53,65,27,153,2087,1934,254,248,517,518,229,147,21,153
53033021400,"Census Tract 214, King County, Washington",14000US53033021400,3154037,242662,4109,4109,3374.171,1.217780546,1886,1371,1173,198,221,0,12,0,19,263,1886,1623,167,282,369,365,322,102,16,263
53033021500,"Census Tract 215, King County, Washington",14000US53033021500,3485702,412518,4516,4516,3355.532,1.345837124,2455,1968,1787,181,210,0,29,8,51,189,2455,2266,85,514,467,494,570,110,26,189
53033021600,"Census Tract 216, King County, Washington",14000US53033021600,2855710,143532,4911,4911,4454.035,1.102595842,2509,1963,1780,183,149,0,8,15,16,358,2509,2151,93,361,443,559,512,139,44,358
53033021700,"Census Tract 217, King County, Washington",14000US53033021700,5665993,0,8618,8618,3939.383,2.187652221,4216,3338,2831,507,471,34,0,19,46,308,4216,3908,163,672,824,886,745,490,128,308
53033021802,"Census Tract 218.02, King County, Washington",14000US53033021802,4904123,0,5495,5495,2902.045,1.893492557,2918,2495,2224,271,137,0,50,0,0,236,2918,2682,313,651,538,546,358,226,50,236
53033021803,"Census Tract 218.03, King County, Washington",14000US53033021803,3280334,0,4694,4694,3706.148,1.266544092,2312,1844,1577,267,174,25,15,33,0,221,2312,2091,322,430,468,366,417,88,0,221
53033021804,"Census Tract 218.04, King County, Washington",14000US53033021804,3067767,0,4684,4684,3954.506,1.184471511,2242,1830,1618,212,132,0,0,52,9,219,2242,2023,216,539,514,260,418,58,18,219
53033021903,"Census Tract 219.03, King County, Washington",14000US53033021903,3133850,10680,5787,5787,4782.699,1.209986301,2816,2335,2023,312,293,0,0,36,0,152,2816,2664,110,680,720,651,252,209,42,152
53033021904,"Census Tract 219.04, King County, Washington",14000US53033021904,3404550,0,4993,4993,3798.39,1.31450416,2740,2251,1947,304,263,13,0,39,86,88,2740,2652,243,540,731,516,436,161,25,88
53033021905,"Census Tract 219.05, King County, Washington",14000US53033021905,2683360,0,5501,5501,5309.583,1.036051132,3231,2620,2298,322,339,0,3,57,0,212,3231,3019,286,686,863,429,456,235,64,212
53033021906,"Census Tract 219.06, King County, Washington",14000US53033021906,3816083,4544,4132,4132,2804.402,1.473397946,2110,1841,1550,291,100,0,7,13,32,117,2110,1993,146,459,438,631,182,129,8,117
53033022001,"Census Tract 220.01, King County, Washington",14000US53033022001,4394633,0,5009,5009,2952.067,1.69677736,2433,2224,1936,288,79,0,13,56,0,61,2433,2372,71,609,472,697,360,163,0,61
53033022003,"Census Tract 220.03, King County, Washington",14000US53033022003,2318497,0,5038,5038,5627.939,0.895176734,2726,2198,1900,298,268,52,29,52,0,127,2726,2599,182,474,630,619,489,171,34,127
53033022005,"Census Tract 220.05, King County, Washington",14000US53033022005,2420124,0,4891,4891,5234.29,0.93441514,3089,2539,2282,257,352,0,22,64,0,112,3089,2977,158,835,720,632,400,214,18,112
53033022006,"Census Tract 220.06, King County, Washington",14000US53033022006,1408907,0,3744,3744,6882.58,0.543982057,1964,1714,1489,225,151,10,0,0,10,79,1964,1885,161,432,489,441,199,153,10,79
53033022101,"Census Tract 221.01, King County, Washington",14000US53033022101,3662797,1581554,4740,4740,3351.685,1.414213888,2302,1803,1565,238,200,18,48,12,23,198,2302,2104,50,275,413,671,491,183,21,198
53033022102,"Census Tract 221.02, King County, Washington",14000US53033022102,4646226,0,6331,6331,3529.147,1.793917964,2963,2664,2409,255,171,0,0,0,22,106,2963,2857,58,492,622,944,563,155,23,106
53033022201,"Census Tract 222.01, King County, Washington",14000US53033022201,2290376,0,4483,4483,5069.437,0.884319155,2367,1838,1634,204,303,16,0,28,0,182,2367,2185,157,446,511,420,473,160,18,182
53033022202,"Census Tract 222.02, King County, Washington",14000US53033022202,2613884,0,7814,7814,7742.565,1.009226298,4589,3577,3254,323,447,68,31,121,0,345,4589,4244,316,884,1255,666,709,297,117,345
53033022203,"Census Tract 222.03, King County, Washington",14000US53033022203,3205513,619554,5030,5030,4064.136,1.237655541,2678,2303,2086,217,207,0,0,33,17,118,2678,2560,109,564,586,640,504,148,9,118
53033022300,"Census Tract 223, King County, Washington",14000US53033022300,5180190,3747695,2603,2603,1301.446,2.000082626,1302,983,899,84,96,8,16,28,9,162,1302,1140,82,249,194,245,213,157,0,162
53033022400,"Census Tract 224, King County, Washington",14000US53033022400,4644860,3758058,8832,8832,4924.75,1.793390549,4702,3645,3332,313,295,16,25,189,75,457,4702,4245,466,1261,1169,726,433,144,46,457
53033022500,"Census Tract 225, King County, Washington",14000US53033022500,3774561,188853,7290,7290,5002.174,1.457366212,3984,3053,2859,194,453,13,0,67,53,345,3984,3639,302,1179,947,716,348,99,48,345
53033022603,"Census Tract 226.03, King County, Washington",14000US53033022603,2896820,12563,5627,5627,5030.986,1.118468503,3090,2599,2213,386,203,11,35,15,36,191,3090,2899,146,665,958,478,441,138,73,191
53033022604,"Census Tract 226.04, King County, Washington",14000US53033022604,2955131,0,4532,4532,3972.015,1.140982506,2393,2000,1885,115,186,4,6,29,22,146,2393,2247,181,927,482,319,221,93,24,146
53033022605,"Census Tract 226.05, King County, Washington",14000US53033022605,4727320,0,6162,6162,3376.016,1.825228534,3354,2908,2491,417,256,0,13,114,17,46,3354,3308,250,1312,860,611,171,87,17,46
53033022606,"Census Tract 226.06, King County, Washington",14000US53033022606,2757465,27137,5981,5981,5617.739,1.064663234,3172,2688,2411,277,167,0,65,70,39,143,3172,3029,201,1232,670,484,387,55,0,143
53033022701,"Census Tract 227.01, King County, Washington",14000US53033022701,1658813,463268,2506,2506,3912.744,0.640471307,1347,1010,962,48,119,8,8,28,18,156,1347,1191,170,506,248,189,29,49,0,156
53033022702,"Census Tract 227.02, King County, Washington",14000US53033022702,2450337,0,3827,3827,4045.111,0.946080445,1873,1322,1274,48,164,0,13,179,3,192,1873,1681,363,529,329,339,102,18,1,192
53033022703,"Census Tract 227.03, King County, Washington",14000US53033022703,4207715,0,2273,2273,1399.107,1.624607913,1143,893,815,78,84,2,25,23,0,116,1143,1027,85,418,205,167,106,18,28,116
53033022801,"Census Tract 228.01, King County, Washington",14000US53033022801,4865268,0,8374,8374,4457.834,1.878490557,4554,3248,2703,545,799,0,26,333,10,138,4554,4416,554,1827,708,606,585,54,82,138
53033022802,"Census Tract 228.02, King County, Washington",14000US53033022802,2657468,0,4772,4772,4650.827,1.026054175,2363,1832,1590,242,232,0,36,17,0,246,2363,2117,252,780,440,339,217,80,9,246
53033022803,"Census Tract 228.03, King County, Washington",14000US53033022803,4772689,0,5362,5362,2909.789,1.842745603,2800,1917,1765,152,505,0,19,314,0,45,2800,2755,857,874,379,348,180,67,50,45
53033022901,"Census Tract 229.01, King County, Washington",14000US53033022901,1484063,0,2918,2918,5092.496,0.572999952,1352,1069,951,118,106,0,28,19,30,100,1352,1252,187,465,248,200,133,19,0,100
53033022902,"Census Tract 229.02, King County, Washington",14000US53033022902,3427199,1688812,6492,6492,4906.106,1.323248988,2955,2531,2279,252,78,34,35,73,15,189,2955,2766,498,1089,473,298,300,93,15,189
53033023000,"Census Tract 230, King County, Washington",14000US53033023000,3286160,2508903,5000,5000,3940.751,1.268793523,2492,2005,1860,145,216,8,0,23,0,240,2492,2252,150,792,620,408,199,69,14,240
53033023100,"Census Tract 231, King County, Washington",14000US53033023100,2531810,2665265,4032,4032,4124.65,0.977537348,1934,1507,1295,212,220,8,27,72,0,100,1934,1834,150,637,475,274,211,53,34,100
53033023201,"Census Tract 232.01, King County, Washington",14000US53033023201,1589789,0,6449,6449,10506.32,0.613820991,3613,2284,1823,461,1054,0,0,142,0,133,3613,3480,449,1452,471,505,352,186,65,133
53033023202,"Census Tract 232.02, King County, Washington",14000US53033023202,1470662,0,4698,4698,8273.664,0.567825797,2379,1794,1579,215,306,0,5,169,10,95,2379,2284,172,857,531,474,155,78,17,95
53033023300,"Census Tract 233, King County, Washington",14000US53033023300,3589676,248744,6306,6306,4549.844,1.385981711,3239,2550,2266,284,407,0,0,91,16,175,3239,3064,203,1102,676,628,322,133,0,175
53033023401,"Census Tract 234.01, King County, Washington",14000US53033023401,3740203,0,3550,3550,2458.278,1.444100513,1712,1447,1283,164,149,0,25,33,0,58,1712,1654,120,711,367,223,182,37,14,58
53033023403,"Census Tract 234.03, King County, Washington",14000US53033023403,3308890,1972210,4173,4173,3266.358,1.277569626,1935,1589,1407,182,167,31,0,32,0,116,1935,1819,137,748,333,391,192,18,0,116
53033023404,"Census Tract 234.04, King County, Washington",14000US53033023404,1793702,1870257,3308,3308,4776.535,0.692552243,1926,1632,1507,125,113,7,10,16,11,137,1926,1789,115,398,594,393,220,58,11,137
53033023500,"Census Tract 235, King County, Washington",14000US53033023500,2273132,0,3672,3672,4183.847,0.877661209,1691,1426,1301,125,106,6,12,41,0,100,1691,1591,190,576,281,352,145,23,24,100
53033023601,"Census Tract 236.01, King County, Washington",14000US53033023601,4602566,0,3854,3854,2168.75,1.777060743,2016,1615,1525,90,217,3,13,53,9,106,2016,1910,264,641,539,220,222,24,0,106
53033023603,"Census Tract 236.03, King County, Washington",14000US53033023603,2028190,0,6278,6278,8016.973,0.78308857,3459,2356,2090,266,702,0,0,95,62,244,3459,3215,457,1081,646,667,242,122,0,244
53033023604,"Census Tract 236.04, King County, Washington",14000US53033023604,2940216,0,6241,6241,5497.594,1.135223793,3176,2325,2071,254,533,38,36,43,64,137,3176,3039,517,921,877,399,187,125,13,137
53033023700,"Census Tract 237, King County, Washington",14000US53033023700,7530638,18305,4204,4204,1445.868,2.907595711,2267,1826,1645,181,239,22,0,45,0,135,2267,2132,197,861,484,443,88,58,1,135
53033023801,"Census Tract 238.01, King County, Washington",14000US53033023801,3723442,0,2232,2232,1552.556,1.437629055,1287,958,785,173,102,0,0,97,17,113,1287,1174,122,581,213,138,84,17,19,113
53033023803,"Census Tract 238.03, King County, Washington",14000US53033023803,563963,0,5036,5036,23127.72,0.217747341,2603,1349,1277,72,339,0,0,721,0,194,2603,2409,258,1377,270,137,231,119,17,194
53033023804,"Census Tract 238.04, King County, Washington",14000US53033023804,1220954,0,6161,6161,13069.22,0.471412995,4003,2454,2141,313,287,0,0,703,60,499,4003,3504,805,1325,741,451,102,66,14,499
53033023900,"Census Tract 239, King County, Washington",14000US53033023900,4649863,4222583,7013,7013,3906.263,1.795322218,3253,2090,1966,124,404,0,18,396,30,315,3253,2938,294,1256,612,521,165,73,17,315
53033024000,"Census Tract 240, King County, Washington",14000US53033024000,4669788,239079,7880,7880,4370.457,1.803015304,3694,2689,2456,233,314,0,0,311,60,320,3694,3374,569,1385,556,491,194,177,2,320
53033024100,"Census Tract 241, King County, Washington",14000US53033024100,4432887,1658184,4830,4830,2822.008,1.711547312,1983,1643,1550,93,99,11,0,38,19,173,1983,1810,258,801,460,195,56,25,15,173
53033024200,"Census Tract 242, King County, Washington",14000US53033024200,3706733,11129640,3115,3115,2176.529,1.431177673,1043,929,841,88,39,0,0,11,13,51,1043,992,65,477,240,139,54,5,12,51
53033024300,"Census Tract 243, King County, Washington",14000US53033024300,4071795,9463811,8164,8164,5192.958,1.572128906,3623,2946,2710,236,343,14,15,109,17,179,3623,3444,417,1244,1018,536,175,22,32,179
53033024400,"Census Tract 244, King County, Washington",14000US53033024400,1627672,660948,2611,2611,4154.682,0.628447699,1217,955,829,126,136,0,0,24,44,58,1217,1159,109,397,358,177,81,28,9,58
53033024500,"Census Tract 245, King County, Washington",14000US53033024500,3785637,2227321,5003,5003,3422.861,1.461642679,2280,1613,1491,122,143,0,32,34,18,440,2280,1840,170,597,487,314,173,29,70,440
53033024601,"Census Tract 246.01, King County, Washington",14000US53033024601,4016906,2661746,4588,4588,2958.213,1.550936143,1835,1474,1336,138,73,0,38,9,32,209,1835,1626,127,413,620,273,176,7,10,209
53033024602,"Census Tract 246.02, King County, Washington",14000US53033024602,2868432,2569219,3754,3754,3389.592,1.107507834,1473,1194,1062,132,74,0,10,0,8,187,1473,1286,15,286,357,361,259,0,8,187
53033024701,"Census Tract 247.01, King County, Washington",14000US53033024701,2739207,0,3866,3866,3655.399,1.05761378,1933,1582,1426,156,168,12,0,11,11,149,1933,1784,70,549,517,320,243,33,52,149
53033024702,"Census Tract 247.02, King County, Washington",14000US53033024702,6392898,797574,7791,7791,3156.408,2.468311822,4016,3435,3063,372,252,0,53,47,19,210,4016,3806,125,1009,1290,752,478,88,64,210
53033024800,"Census Tract 248, King County, Washington",14000US53033024800,3775702,0,5666,5666,3886.661,1.457806754,2688,2171,1962,209,291,0,10,61,0,155,2688,2533,314,916,701,494,63,34,11,155
53033024901,"Census Tract 249.01, King County, Washington",14000US53033024901,3183749,0,5063,5063,4118.764,1.229252414,2152,1642,1458,184,182,7,0,0,5,316,2152,1836,100,402,724,307,186,80,37,316
53033024902,"Census Tract 249.02, King County, Washington",14000US53033024902,2029984,0,3769,3769,4808.74,0.783781238,1898,1644,1426,218,98,0,0,0,0,156,1898,1742,95,456,417,405,240,108,21,156
53033024903,"Census Tract 249.03, King County, Washington",14000US53033024903,4963596,0,6980,6980,3642.141,1.916455211,3444,2843,2418,425,282,0,0,12,19,288,3444,3156,44,817,890,573,603,132,97,288
53033025001,"Census Tract 250.01, King County, Washington",14000US53033025001,3531217,28798,4786,4786,3510.315,1.363410564,2495,2062,1872,190,163,14,0,18,0,238,2495,2257,181,607,595,502,304,61,7,238
53033025003,"Census Tract 250.03, King County, Washington",14000US53033025003,6352436,0,6979,6979,2845.448,2.452689356,3254,2830,2509,321,180,14,12,14,53,151,3254,3103,166,738,843,718,415,144,79,151
53033025005,"Census Tract 250.05, King County, Washington",14000US53033025005,7684826,0,4696,4696,1582.675,2.967128033,2439,2188,2071,117,89,8,23,24,22,85,2439,2354,111,447,751,585,410,44,6,85
53033025006,"Census Tract 250.06, King County, Washington",14000US53033025006,22393618,0,6008,6008,694.8698,8.646224616,3190,2735,2340,395,119,0,21,0,0,315,3190,2875,254,569,818,657,401,148,28,315
53033025101,"Census Tract 251.01, King County, Washington",14000US53033025101,2935513,0,5584,5584,4926.734,1.133407954,2797,2561,2186,375,70,0,0,51,14,101,2797,2696,147,288,610,949,616,72,14,101
53033025102,"Census Tract 251.02, King County, Washington",14000US53033025102,6232169,0,7729,7729,3212.047,2.406254006,3899,3449,3165,284,209,0,0,70,14,157,3899,3742,121,680,1026,772,789,299,55,157
53033025200,"Census Tract 252, King County, Washington",14000US53033025200,4544252,0,8098,8098,4615.44,1.754545581,4265,3576,3068,508,246,0,0,31,65,347,4265,3918,245,878,1093,813,722,135,32,347
53033025301,"Census Tract 253.01, King County, Washington",14000US53033025301,3821608,2029946,5691,5691,3856.916,1.475531161,3413,2942,2702,240,148,0,35,98,0,190,3413,3223,146,974,583,845,545,100,30,190
53033025302,"Census Tract 253.02, King County, Washington",14000US53033025302,3972686,2424838,5263,5263,3431.207,1.533862705,2506,1726,1395,331,568,14,34,89,13,62,2506,2444,102,697,298,509,497,260,81,62
53033025400,"Census Tract 254, King County, Washington",14000US53033025400,2300848,0,7245,7245,8155.455,0.888362417,3946,3309,2775,534,466,51,0,63,0,57,3946,3889,444,706,913,904,525,335,62,57
53033025500,"Census Tract 255, King County, Washington",14000US53033025500,1524600,0,5020,5020,8527.968,0.588651376,2835,2556,2118,438,157,0,0,39,17,66,2835,2769,167,623,595,721,393,238,32,66
53033025601,"Census Tract 256.01, King County, Washington",14000US53033025601,2894103,0,5113,5113,4575.721,1.117419463,2825,2459,2108,351,201,10,25,14,32,84,2825,2741,140,485,713,598,477,277,51,84
53033025602,"Census Tract 256.02, King County, Washington",14000US53033025602,5204940,0,6470,6470,3219.484,2.009638655,3366,2956,2510,446,134,11,7,69,0,189,3366,3177,141,519,864,892,550,166,45,189
53033025701,"Census Tract 257.01, King County, Washington",14000US53033025701,3780704,0,5387,5387,3690.388,1.459738037,2931,2693,2432,261,159,16,0,0,14,49,2931,2882,365,469,711,630,513,107,87,49
53033025702,"Census Tract 257.02, King County, Washington",14000US53033025702,2852893,0,3593,3593,3261.891,1.101508192,1769,1615,1493,122,48,0,0,9,7,90,1769,1679,80,196,507,471,327,79,19,90
53033025803,"Census Tract 258.03, King County, Washington",14000US53033025803,1343482,0,5039,5039,9714.271,0.518721322,2330,2092,1608,484,159,0,0,0,0,79,2330,2251,114,536,441,360,364,305,131,79
53033025804,"Census Tract 258.04, King County, Washington",14000US53033025804,2358347,0,3840,3840,4217.171,0.910562906,1965,1653,1358,295,117,9,11,26,33,116,1965,1849,76,475,404,434,285,139,36,116
53033025805,"Census Tract 258.05, King County, Washington",14000US53033025805,2392257,35493,5248,5248,5681.771,0.923655631,2543,2104,1703,401,216,0,0,59,18,146,2543,2397,205,689,423,561,219,209,91,146
53033025806,"Census Tract 258.06, King County, Washington",14000US53033025806,2934558,150285,4811,4811,4246.102,1.133039226,2406,1981,1436,545,247,0,0,16,0,162,2406,2244,150,595,286,548,423,228,14,162
53033026001,"Census Tract 260.01, King County, Washington",14000US53033026001,2747927,0,5755,5755,5424.228,1.060980591,2822,2513,1880,633,194,27,0,0,0,88,2822,2734,115,531,909,682,343,134,20,88
53033026002,"Census Tract 260.02, King County, Washington",14000US53033026002,2767309,1607,8967,8967,8392.421,1.068464024,4345,3378,2820,558,535,30,0,256,73,73,4345,4272,271,927,1048,1100,578,221,127,73
53033026100,"Census Tract 261, King County, Washington",14000US53033026100,4302988,9859,6552,6552,3943.678,1.661393026,2880,2568,2177,391,172,0,0,11,50,79,2880,2801,22,869,677,495,397,287,54,79
53033026200,"Census Tract 262, King County, Washington",14000US53033026200,15241096,526900,5645,5645,959.2802,5.884620315,3023,2677,2198,479,215,0,18,103,0,10,3023,3013,561,1108,421,414,230,193,86,10
53033026300,"Census Tract 263, King County, Washington",14000US53033026300,4827827,388852,1587,1587,851.3791,1.864034505,737,637,538,99,61,0,0,30,0,9,737,728,48,278,138,160,77,17,10,9
53033026400,"Census Tract 264, King County, Washington",14000US53033026400,4780011,299442,5711,5711,3094.433,1.845572644,2850,2388,1895,493,264,0,0,73,42,83,2850,2767,297,870,567,559,207,169,98,83
53033026500,"Census Tract 265, King County, Washington",14000US53033026500,1993802,1625,4313,4313,5602.672,0.769811289,1770,1396,1191,205,336,0,0,28,0,10,1770,1760,136,553,303,406,204,129,29,10
53033026600,"Census Tract 266, King County, Washington",14000US53033026600,1160397,0,2840,2840,6338.835,0.448031806,1371,1171,932,239,93,0,15,29,20,43,1371,1328,132,371,226,241,180,142,36,43
53033026700,"Census Tract 267, King County, Washington",14000US53033026700,3084839,419292,5056,5056,4244.947,1.191063047,2274,1835,1589,246,350,0,0,0,0,89,2274,2185,74,289,421,551,444,204,202,89
53033026801,"Census Tract 268.01, King County, Washington",14000US53033026801,1538512,5897,5530,5530,9309.406,0.594022829,2835,2106,1847,259,468,0,70,123,0,68,2835,2767,257,672,670,519,338,77,234,68
53033026802,"Census Tract 268.02, King County, Washington",14000US53033026802,2035727,18135,4932,4932,6274.82,0.785998622,2171,1903,1483,420,185,0,8,27,13,35,2171,2136,127,540,446,554,250,144,75,35
53033027000,"Census Tract 270, King County, Washington",14000US53033027000,1978526,12524,3552,3552,4649.743,0.763913192,1734,1530,1233,297,119,3,0,25,7,50,1734,1684,169,543,346,379,137,87,23,50
53033027100,"Census Tract 271, King County, Washington",14000US53033027100,1567464,0,3324,3324,5492.388,0.60520126,1243,1053,992,61,159,20,0,0,0,11,1243,1232,154,377,176,246,141,105,33,11
53033027200,"Census Tract 272, King County, Washington",14000US53033027200,3321974,85339,2545,2545,1984.218,1.282621387,1121,913,783,130,71,6,19,30,32,50,1121,1071,147,321,197,193,138,56,19,50
53033027300,"Census Tract 273, King County, Washington",14000US53033027300,3552158,5405,6205,6205,4524.257,1.37149593,2642,1918,1611,307,488,0,0,131,20,85,2642,2557,206,827,445,467,345,158,109,85
53033027400,"Census Tract 274, King County, Washington",14000US53033027400,3325461,0,5079,5079,3955.707,1.283967725,2442,2084,1638,446,125,39,0,54,62,78,2442,2364,253,956,422,299,293,107,34,78
53033027500,"Census Tract 275, King County, Washington",14000US53033027500,2229521,0,4828,4828,5608.587,0.860822907,2199,1874,1489,385,146,0,33,62,0,84,2199,2115,146,694,602,284,199,157,33,84
53033027600,"Census Tract 276, King County, Washington",14000US53033027600,2846424,1307943,4955,4955,4508.601,1.099010497,2198,1722,1510,212,256,14,0,20,73,113,2198,2085,204,515,480,323,193,288,82,113
53033027701,"Census Tract 277.01, King County, Washington",14000US53033027701,44151776,9781558,5565,5565,326.4485,17.04709674,2989,1898,1670,228,641,18,91,88,49,204,2989,2785,482,809,81,64,248,701,400,204
53033027702,"Census Tract 277.02, King County, Washington",14000US53033027702,51481975,23439547,4624,4624,232.6271,19.87730291,2211,1448,1381,67,427,0,68,24,34,210,2211,2001,227,599,57,96,64,444,514,210
53033027800,"Census Tract 278, King County, Washington",14000US53033027800,2577267,1094948,3213,3213,3228.859,0.995088394,1461,1288,1183,105,65,0,7,25,14,62,1461,1399,174,350,218,297,271,67,22,62
53033027900,"Census Tract 279, King County, Washington",14000US53033027900,3358042,153582,7322,7322,5647.307,1.29654732,3976,3301,2889,412,320,16,21,186,0,132,3976,3844,359,1211,767,704,512,291,0,132
53033028000,"Census Tract 280, King County, Washington",14000US53033028000,2094341,0,4029,4029,4982.503,0.808629615,1800,1435,1172,263,188,0,0,119,19,39,1800,1761,146,576,503,224,191,80,41,39
53033028100,"Census Tract 281, King County, Washington",14000US53033028100,1627778,0,2439,2439,3880.739,0.628488626,1157,904,797,107,162,0,0,60,21,10,1157,1147,117,241,156,180,336,78,39,10
53033028200,"Census Tract 282, King County, Washington",14000US53033028200,2687326,1028,4989,4989,4808.293,1.037582414,2538,1905,1553,352,483,9,0,0,78,63,2538,2475,300,446,475,702,301,236,15,63
53033028300,"Census Tract 283, King County, Washington",14000US53033028300,8206439,153403,5018,5018,1583.703,3.168523947,2770,2363,1948,415,310,9,8,18,6,56,2770,2714,161,1013,385,456,469,149,81,56
53033028402,"Census Tract 284.02, King County, Washington",14000US53033028402,8324279,0,4793,4793,1491.278,3.214022227,2128,1620,1441,179,225,0,7,188,47,41,2128,2087,264,609,457,391,138,166,62,41
53033028403,"Census Tract 284.03, King County, Washington",14000US53033028403,2086535,32665,5232,5232,6494.412,0.805615702,2327,1588,1318,270,442,0,20,77,57,143,2327,2184,240,707,184,291,232,205,325,143
53033028500,"Census Tract 285, King County, Washington",14000US53033028500,3509824,0,3885,3885,2866.84,1.35515068,1922,1615,1445,170,168,0,73,0,13,53,1922,1869,186,633,384,292,179,106,89,53
53033028600,"Census Tract 286, King County, Washington",14000US53033028600,6463133,1891466,6597,6597,2643.633,2.495429709,3223,2886,2582,304,76,16,20,11,0,214,3223,3009,491,716,658,454,503,146,41,214
53033028700,"Census Tract 287, King County, Washington",14000US53033028700,2675325,0,5127,5127,4963.46,1.032948801,2443,2193,1929,264,110,0,0,11,4,125,2443,2318,249,797,487,404,193,159,29,125
53033028801,"Census Tract 288.01, King County, Washington",14000US53033028801,5203599,0,2981,2981,1483.734,2.009120892,1047,916,803,113,83,0,0,8,0,40,1047,1007,53,271,298,174,89,107,15,40
53033028802,"Census Tract 288.02, King County, Washington",14000US53033028802,2415612,415841,7075,7075,7585.724,0.932673047,3180,2559,2254,305,414,8,0,111,0,88,3180,3092,162,961,619,649,327,252,122,88
53033028901,"Census Tract 289.01, King County, Washington",14000US53033028901,2285605,425573,3475,3475,3937.779,0.882477062,1948,1583,1332,251,220,17,0,36,12,80,1948,1868,222,590,266,298,184,242,66,80
53033028902,"Census Tract 289.02, King County, Washington",14000US53033028902,2062176,0,6575,6575,8257.865,0.796210639,3080,2352,1881,471,370,0,0,86,0,272,3080,2808,210,801,604,401,356,378,58,272
53033029001,"Census Tract 290.01, King County, Washington",14000US53033029001,2635370,952681,4446,4446,4369.438,1.017522089,1976,1740,1537,203,129,23,0,41,17,26,1976,1950,172,592,326,394,259,147,60,26
53033029003,"Census Tract 290.03, King County, Washington",14000US53033029003,2574768,0,5950,5950,5985.172,0.994123525,2838,2443,1872,571,266,0,49,14,18,48,2838,2790,173,576,865,484,390,201,101,48
53033029004,"Census Tract 290.04, King County, Washington",14000US53033029004,1825372,0,3706,3706,5258.378,0.704780099,1472,960,785,175,235,29,21,98,110,19,1472,1453,80,277,354,228,294,138,82,19
53033029101,"Census Tract 291.01, King County, Washington",14000US53033029101,3352098,167811,2958,2958,2285.49,1.294252329,1569,1396,1203,193,115,0,7,0,28,23,1569,1546,102,601,203,325,213,76,26,23
53033029102,"Census Tract 291.02, King County, Washington",14000US53033029102,2582809,0,4017,4017,4028.165,0.997228172,1927,1744,1430,314,65,0,0,78,21,19,1927,1908,117,569,443,321,330,81,47,19
53033029203,"Census Tract 292.03, King County, Washington",14000US53033029203,2010123,0,3817,3817,4918.099,0.776112862,1066,863,773,90,85,0,0,75,0,43,1066,1023,83,279,162,250,96,146,7,43
53033029204,"Census Tract 292.04, King County, Washington",14000US53033029204,4234266,1687,7152,7152,4374.688,1.634859312,3536,3043,2702,341,272,9,0,54,22,136,3536,3400,301,999,524,567,596,275,138,136
53033029205,"Census Tract 292.05, King County, Washington",14000US53033029205,1868727,40406,5076,5076,7035.152,0.721519559,2630,2349,1853,496,204,0,39,0,0,38,2630,2592,123,739,350,473,319,566,22,38
53033029206,"Census Tract 292.06, King County, Washington",14000US53033029206,17212475,214543,4288,4288,645.222,6.645774421,1936,1504,1167,337,218,0,4,127,32,51,1936,1885,229,603,221,351,153,276,52,51
53033029303,"Census Tract 293.03, King County, Washington",14000US53033029303,3608397,1116,7493,7493,5378.228,1.39320993,4041,3613,3206,407,253,0,0,0,16,159,4041,3882,332,721,975,755,509,590,0,159
53033029304,"Census Tract 293.04, King County, Washington",14000US53033029304,4132285,30364,5284,5284,3311.847,1.595484226,2769,2529,2204,325,164,35,8,8,10,15,2769,2754,67,837,576,447,502,211,114,15
53033029305,"Census Tract 293.05, King County, Washington",14000US53033029305,2897239,2248,3891,3891,3478.361,1.118630279,1925,1674,1380,294,100,7,0,47,30,67,1925,1858,135,529,301,348,267,266,12,67
53033029306,"Census Tract 293.06, King County, Washington",14000US53033029306,2372855,182821,3368,3368,3676.196,0.916164476,1762,1565,1296,269,104,0,0,0,7,86,1762,1676,95,441,272,439,291,93,45,86
53033029307,"Census Tract 293.07, King County, Washington",14000US53033029307,3808766,61769,4264,4264,2899.55,1.470572837,2196,2020,1723,297,23,0,0,0,55,98,2196,2098,131,537,375,528,184,309,34,98
53033029403,"Census Tract 294.03, King County, Washington",14000US53033029403,2407382,385,5707,5707,6139.89,0.929495426,2790,2332,1926,406,252,13,0,13,19,161,2790,2629,119,619,684,437,388,323,59,161
53033029405,"Census Tract 294.05, King County, Washington",14000US53033029405,2491156,986,5781,5781,6010.351,0.96184075,2746,2422,2261,161,136,7,18,38,16,109,2746,2637,136,593,706,573,330,244,55,109
53033029406,"Census Tract 294.06, King County, Washington",14000US53033029406,2616772,92988,5171,5171,5118.072,1.010341361,2555,2226,2023,203,189,7,0,18,32,83,2555,2472,79,477,644,517,416,256,83,83
53033029407,"Census Tract 294.07, King County, Washington",14000US53033029407,1360513,0,4591,4591,8739.817,0.525297028,2047,1752,1423,329,198,0,0,36,0,61,2047,1986,139,458,348,342,436,199,64,61
53033029408,"Census Tract 294.08, King County, Washington",14000US53033029408,1238188,0,4246,4246,8881.599,0.47806708,2207,1982,1776,206,109,0,0,58,36,22,2207,2185,128,419,647,467,259,228,37,22
53033029502,"Census Tract 295.02, King County, Washington",14000US53033029502,4309765,36477,6895,6895,4143.606,1.66400964,3378,3200,2626,574,109,0,0,0,0,69,3378,3309,98,887,885,467,700,203,69,69
53033029503,"Census Tract 295.03, King County, Washington",14000US53033029503,2362193,545,8780,8780,9626.688,0.912047855,3714,3029,2696,333,455,0,0,39,36,155,3714,3559,199,946,940,612,422,244,196,155
53033029504,"Census Tract 295.04, King County, Washington",14000US53033029504,1883400,0,6600,6600,9076.097,0.727184836,2941,2620,2082,538,146,23,0,31,0,121,2941,2820,290,448,894,557,498,115,18,121
53033029601,"Census Tract 296.01, King County, Washington",14000US53033029601,3950607,70584,6555,6555,4297.408,1.525337955,2838,2463,2049,414,209,0,0,14,46,106,2838,2732,118,423,578,746,427,214,226,106
53033029602,"Census Tract 296.02, King County, Washington",14000US53033029602,6659409,50035,5624,5624,2187.295,2.571212299,2632,2351,2086,265,103,0,10,37,7,124,2632,2508,106,692,601,593,302,157,57,124
53033029700,"Census Tract 297, King County, Washington",14000US53033029700,11047288,222690,8290,8290,1943.554,4.265381925,2993,2504,2027,477,134,9,0,87,58,201,2993,2792,331,685,511,642,376,170,77,201
53033029801,"Census Tract 298.01, King County, Washington",14000US53033029801,7901412,164205,8793,8793,2882.24,3.050752359,4145,3647,3014,633,243,0,15,12,109,119,4145,4026,143,830,843,894,457,598,261,119
53033029802,"Census Tract 298.02, King County, Washington",14000US53033029802,6856382,174573,8120,8120,3067.318,2.647264003,4125,3471,3071,400,439,39,0,0,0,176,4125,3949,60,924,1125,671,572,394,203,176
53033029901,"Census Tract 299.01, King County, Washington",14000US53033029901,3958496,107134,4947,4947,3236.752,1.528383915,2223,1915,1692,223,203,22,0,13,0,70,2223,2153,94,553,484,446,332,200,44,70
53033029902,"Census Tract 299.02, King County, Washington",14000US53033029902,6290862,10821,4235,4235,1743.577,2.428915501,2039,1890,1733,157,72,0,5,0,0,72,2039,1967,187,417,547,320,258,177,61,72
53033030003,"Census Tract 300.03, King County, Washington",14000US53033030003,4737504,846303,6432,6432,3516.367,1.829160598,2938,2704,2410,294,88,13,0,50,0,83,2938,2855,146,575,652,628,663,159,32,83
53033030004,"Census Tract 300.04, King County, Washington",14000US53033030004,2038151,0,8106,8106,10300.73,0.786934534,4007,3462,2831,631,387,12,16,0,0,130,4007,3877,101,1064,1130,718,450,367,47,130
53033030005,"Census Tract 300.05, King County, Washington",14000US53033030005,2174223,0,5315,5315,6331.359,0.839472229,2460,2135,1905,230,134,8,0,48,9,126,2460,2334,72,378,596,564,359,240,125,126
53033030006,"Census Tract 300.06, King County, Washington",14000US53033030006,1984562,163997,3884,3884,5068.883,0.766243705,1678,1181,1075,106,233,0,0,96,0,168,1678,1510,146,366,284,335,91,263,25,168
53033030100,"Census Tract 301, King County, Washington",14000US53033030100,5851590,1972452,7790,7790,3447.953,2.259311626,3394,2796,2484,312,273,0,21,0,94,210,3394,3184,130,722,841,700,390,303,98,210
53033030201,"Census Tract 302.01, King County, Washington",14000US53033030201,2818919,52615,5212,5212,4788.721,1.088390757,2548,2166,1950,216,233,0,0,9,22,118,2548,2430,84,270,793,484,544,177,78,118
53033030202,"Census Tract 302.02, King County, Washington",14000US53033030202,3272013,0,6219,6219,4922.699,1.263331336,2729,2247,1836,411,304,0,0,58,0,120,2729,2609,170,402,768,410,491,266,102,120
53033030304,"Census Tract 303.04, King County, Washington",14000US53033030304,7344801,14259,3142,3142,1107.96,2.835843641,1539,1398,1225,173,100,0,0,9,0,32,1539,1507,151,346,305,339,208,113,45,32
53033030305,"Census Tract 303.05, King County, Washington",14000US53033030305,3783120,1035821,5376,5376,3680.501,1.46067086,2516,2037,1829,208,260,0,15,54,32,118,2516,2398,167,337,381,599,545,255,114,118
53033030306,"Census Tract 303.06, King County, Washington",14000US53033030306,3764962,542278,5812,5812,3998.184,1.453660017,2950,2562,2335,227,162,53,8,17,10,138,2950,2812,112,485,520,777,471,330,117,138
53033030308,"Census Tract 303.08, King County, Washington",14000US53033030308,2154064,0,6755,6755,8122.028,0.831688795,3785,3252,2743,509,356,18,13,1,26,119,3785,3666,259,980,702,941,408,304,72,119
53033030309,"Census Tract 303.09, King County, Washington",14000US53033030309,2194426,27034,6151,6151,7259.765,0.847272651,3387,3116,2944,172,131,0,0,86,17,37,3387,3350,390,686,605,783,512,163,211,37
53033030310,"Census Tract 303.10, King County, Washington",14000US53033030310,3205491,0,5519,5519,4459.268,1.237647047,2656,2373,2100,273,73,0,7,5,42,156,2656,2500,135,485,661,520,419,197,83,156
53033030311,"Census Tract 303.11, King County, Washington",14000US53033030311,1900453,3993,5659,5659,7712.236,0.733769037,2458,2159,1804,355,136,0,0,26,13,124,2458,2334,120,309,397,513,500,410,85,124
53033030312,"Census Tract 303.12, King County, Washington",14000US53033030312,1855241,0,4946,4946,6904.807,0.716312585,2478,2013,1622,391,262,11,0,9,17,166,2478,2312,123,377,481,397,513,300,121,166
53033030313,"Census Tract 303.13, King County, Washington",14000US53033030313,4002289,0,3864,3864,2500.498,1.545292488,1679,1415,1079,336,146,11,0,25,0,82,1679,1597,207,378,328,365,170,132,17,82
53033030314,"Census Tract 303.14, King County, Washington",14000US53033030314,2503919,0,4426,4426,4578.138,0.966768572,1799,1220,1117,103,143,0,0,325,0,111,1799,1688,299,460,393,179,192,101,64,111
53033030401,"Census Tract 304.01, King County, Washington",14000US53033030401,12138960,348070,9015,9015,1923.455,4.686878858,4165,3742,3519,223,176,0,0,0,24,223,4165,3942,156,1112,1383,552,478,192,69,223
53033030403,"Census Tract 304.03, King County, Washington",14000US53033030403,3853306,6562,4469,4469,3003.825,1.487769828,2195,1895,1578,317,145,0,0,0,0,155,2195,2040,60,531,531,417,208,218,75,155
53033030404,"Census Tract 304.04, King County, Washington",14000US53033030404,5989875,215746,4867,4867,2104.463,2.312703765,2269,2095,1732,363,55,44,0,0,23,52,2269,2217,139,554,457,448,375,195,49,52
53033030501,"Census Tract 305.01, King County, Washington",14000US53033030501,11215570,175434,1734,1734,400.429,4.330355971,627,488,410,78,69,0,10,21,5,34,627,593,62,202,127,73,81,41,7,34
53033030503,"Census Tract 305.03, King County, Washington",14000US53033030503,3258095,67676,5661,5661,4500.152,1.257957566,2284,1944,1547,397,226,0,26,57,18,13,2284,2271,298,296,544,442,287,360,44,13
53033030504,"Census Tract 305.04, King County, Washington",14000US53033030504,1524229,42763,4302,4302,7310.009,0.588508132,1872,1670,1470,200,121,5,0,40,4,32,1872,1840,264,404,512,335,144,153,28,32
53033030600,"Census Tract 306, King County, Washington",14000US53033030600,3359294,69662,5544,5544,4274.378,1.29703072,2547,2066,1755,311,176,16,22,143,62,62,2547,2485,398,729,510,335,274,117,122,62
53033030700,"Census Tract 307, King County, Washington",14000US53033030700,1563564,0,3868,3868,6407.204,0.603695461,1532,1447,1294,153,31,0,7,19,0,28,1532,1504,190,511,215,294,232,47,15,28
53033030801,"Census Tract 308.01, King County, Washington",14000US53033030801,6975768,33797,7373,7373,2737.474,2.693359197,2762,2373,1935,438,246,0,16,26,33,68,2762,2694,186,412,753,556,424,243,120,68
53033030802,"Census Tract 308.02, King County, Washington",14000US53033030802,1372874,0,3835,3835,7234.898,0.530069637,1675,1435,1158,277,126,12,0,8,9,85,1675,1590,99,420,341,165,302,116,147,85
53033030901,"Census Tract 309.01, King County, Washington",14000US53033030901,3121503,0,3647,3647,3026.006,1.205219098,1705,1526,1344,182,94,10,11,34,0,30,1705,1675,203,375,353,335,243,127,39,30
53033030902,"Census Tract 309.02, King County, Washington",14000US53033030902,3926189,28185,6002,6002,3959.338,1.515910112,2581,2212,1823,389,183,10,41,70,0,65,2581,2516,308,535,494,515,452,103,109,65
53033031000,"Census Tract 310, King County, Washington",14000US53033031000,12595437,162785,3805,3805,782.4186,4.863125621,1902,1650,1517,133,131,7,6,0,0,108,1902,1794,165,395,389,356,272,147,70,108
53033031100,"Census Tract 311, King County, Washington",14000US53033031100,7323964,116159,6861,6861,2426.269,2.82779843,3116,2483,2212,271,250,3,0,142,0,238,3116,2878,309,843,490,480,363,226,167,238
53033031202,"Census Tract 312.02, King County, Washington",14000US53033031202,66664775,755179,6151,6151,238.972,25.73941501,2480,2145,1915,230,24,0,0,66,39,206,2480,2274,287,352,323,430,556,282,44,206
53033031204,"Census Tract 312.04, King County, Washington",14000US53033031204,36871877,608947,5780,5780,406.004,14.23631152,2820,2392,2225,167,122,0,0,32,14,260,2820,2560,162,459,594,533,422,302,88,260
53033031205,"Census Tract 312.05, King County, Washington",14000US53033031205,5853259,41398,6738,6738,2981.474,2.259956031,2996,2592,2288,304,329,14,0,0,43,18,2996,2978,235,546,541,412,648,421,175,18
53033031206,"Census Tract 312.06, King County, Washington",14000US53033031206,3668962,60430,5143,5143,3630.539,1.416594208,2295,2044,1780,264,95,0,0,49,45,62,2295,2233,208,683,300,322,415,278,27,62
53033031301,"Census Tract 313.01, King County, Washington",14000US53033031301,33118748,224283,2781,2781,217.4828,12.78722064,1100,924,801,123,6,0,0,31,0,139,1100,961,138,153,145,111,262,124,28,139
53033031302,"Census Tract 313.02, King County, Washington",14000US53033031302,10879017,100642,4017,4017,956.3347,4.200412125,2032,1848,1684,164,33,0,0,23,42,86,2032,1946,482,268,251,162,455,270,58,86
53033031400,"Census Tract 314, King County, Washington",14000US53033031400,6377757,1179,6053,6053,2458.105,2.462465849,3047,2680,2467,213,45,41,19,138,0,124,3047,2923,645,248,321,656,694,276,83,124
53033031501,"Census Tract 315.01, King County, Washington",14000US53033031501,161442521,1999864,4285,4285,68.74334,62.3333112,2159,1999,1779,220,0,0,0,20,44,96,2159,2063,70,342,284,296,713,255,103,96
53033031502,"Census Tract 315.02, King County, Washington",14000US53033031502,1026438098,8763580,4287,4287,10.81729,396.3099752,1891,1750,1513,237,17,0,23,6,14,81,1891,1810,271,233,146,252,606,238,64,81
53033031601,"Census Tract 316.01, King County, Washington",14000US53033031601,14669801,418507,5384,5384,950.5579,5.664042073,2952,2596,2386,210,98,0,0,43,37,178,2952,2774,68,430,539,743,611,335,48,178
53033031603,"Census Tract 316.03, King County, Washington",14000US53033031603,56004069,1525160,5997,5997,277.3398,21.62329246,2809,2519,2271,248,35,0,0,17,18,220,2809,2589,193,330,401,432,851,304,78,220
53033031604,"Census Tract 316.04, King County, Washington",14000US53033031604,4154795,3229,5468,5468,3408.605,1.604175386,2765,2385,2185,200,123,18,0,62,49,128,2765,2637,165,241,383,492,804,364,188,128
53033031605,"Census Tract 316.05, King County, Washington",14000US53033031605,15390877,1564307,3703,3703,623.1436,5.942451085,1777,1635,1517,118,44,0,0,10,19,69,1777,1708,146,219,246,395,388,201,113,69
53033031703,"Census Tract 317.03, King County, Washington",14000US53033031703,7139218,643846,6719,6719,2437.54,2.756467598,3582,3315,2963,352,130,12,0,0,0,125,3582,3457,144,880,978,663,505,227,60,125
53033031704,"Census Tract 317.04, King County, Washington",14000US53033031704,5745119,12142,5383,5383,2426.739,2.218202941,2769,2451,2114,337,210,0,0,29,0,79,2769,2690,101,343,544,683,638,277,104,79
53033031705,"Census Tract 317.05, King County, Washington",14000US53033031705,5049452,4701,4202,4202,2155.309,1.9496044,2344,2152,1804,348,81,0,0,0,0,111,2344,2233,44,394,520,580,439,203,53,111
53033031706,"Census Tract 317.06, King County, Washington",14000US53033031706,4169865,7815,6699,6699,4160.885,1.609993946,3000,2676,2328,348,141,0,0,23,9,151,3000,2849,126,408,733,812,520,159,91,151
53033031800,"Census Tract 318, King County, Washington",14000US53033031800,24842882,3331034,4640,4640,483.7419,9.591890773,2521,2317,1996,321,51,11,0,11,0,131,2521,2390,103,560,598,602,415,100,12,131
53033031903,"Census Tract 319.03, King County, Washington",14000US53033031903,11736814,0,6642,6642,1465.704,4.531609413,3137,2786,2453,333,145,19,0,38,0,149,3137,2988,60,559,692,692,711,204,70,149
53033031904,"Census Tract 319.04, King County, Washington",14000US53033031904,18942604,168049,3486,3486,476.6345,7.313780604,1758,1406,1186,220,116,0,0,24,8,204,1758,1554,81,286,384,313,359,131,0,204
53033031906,"Census Tract 319.06, King County, Washington",14000US53033031906,10822092,521709,3813,3813,912.543,4.178433259,1838,1586,1349,237,58,0,0,0,0,194,1838,1644,110,189,357,477,324,157,30,194
53033031907,"Census Tract 319.07, King County, Washington",14000US53033031907,5537497,0,7735,7735,3617.8,2.138039636,4270,3826,3638,188,160,30,0,9,0,245,4270,4025,38,818,772,988,934,437,38,245
53033031908,"Census Tract 319.08, King County, Washington",14000US53033031908,1827096,0,4595,4595,6513.612,0.70544574,2465,2207,1655,552,127,0,0,38,0,93,2465,2372,98,341,538,566,638,128,63,93
53033031909,"Census Tract 319.09, King County, Washington",14000US53033031909,1916060,0,3227,3227,4362.02,0.739794933,1694,1470,1309,161,128,0,0,0,10,86,1694,1608,37,325,395,330,322,161,38,86
53033032002,"Census Tract 320.02, King County, Washington",14000US53033032002,27571053,210070,3373,3373,316.8551,10.64524314,1457,1349,1201,148,16,0,31,0,11,50,1457,1407,0,63,506,333,355,108,42,50
53033032003,"Census Tract 320.03, King County, Washington",14000US53033032003,122163698,304929,5148,5148,109.1426,47.16766873,2360,2101,1933,168,45,0,0,52,24,138,2360,2222,179,219,427,697,368,282,50,138
53033032005,"Census Tract 320.05, King County, Washington",14000US53033032005,6298146,123257,7160,7160,2944.408,2.431727869,3767,3489,3071,418,123,0,21,0,34,100,3767,3667,150,467,782,1069,872,236,91,100
53033032006,"Census Tract 320.06, King County, Washington",14000US53033032006,7610917,126568,4567,4567,1554.146,2.938591607,2463,2148,1905,243,52,0,10,60,29,164,2463,2299,203,251,399,442,784,153,67,164
53033032007,"Census Tract 320.07, King County, Washington",14000US53033032007,11492547,144662,3611,3611,813.7836,4.437297393,1882,1636,1507,129,56,19,0,19,8,144,1882,1738,83,312,311,435,328,228,41,144
53033032008,"Census Tract 320.08, King County, Washington",14000US53033032008,2292594,159030,4253,4253,4804.697,0.88517553,2030,1910,1740,170,46,0,0,0,10,64,2030,1966,64,317,326,504,446,212,97,64
53033032010,"Census Tract 320.10, King County, Washington",14000US53033032010,4820859,0,5508,5508,2959.152,1.861344145,2402,2184,1849,335,131,0,0,0,0,87,2402,2315,178,239,262,473,746,318,99,87
53033032011,"Census Tract 320.11, King County, Washington",14000US53033032011,3363748,282990,4470,4470,3441.77,1.298750419,2172,1947,1758,189,49,0,0,17,18,141,2172,2031,277,219,199,484,553,219,80,141
53033032102,"Census Tract 321.02, King County, Washington",14000US53033032102,79040166,84391,5063,5063,165.9044,30.51758078,2610,2069,1974,95,153,20,17,65,7,279,2610,2331,130,408,350,693,477,242,31,279
53033032103,"Census Tract 321.03, King County, Washington",14000US53033032103,4051480,0,4347,4347,2778.905,1.56428524,2439,1924,1727,197,268,53,8,130,7,49,2439,2390,534,478,447,473,315,136,7,49
53033032104,"Census Tract 321.04, King County, Washington",14000US53033032104,22481612,0,5985,5985,689.5003,8.68019929,3119,2480,2295,185,163,26,0,29,18,403,3119,2716,187,551,472,815,449,182,60,403
53033032203,"Census Tract 322.03, King County, Washington",14000US53033032203,10073205,3779419,7530,7530,1936.088,3.88928636,3506,2766,2523,243,216,12,21,46,0,445,3506,3061,156,470,899,614,714,177,31,445
53033032207,"Census Tract 322.07, King County, Washington",14000US53033032207,4572913,1055367,3300,3300,1869.041,1.765611655,1647,1416,1340,76,48,0,10,0,7,166,1647,1481,45,278,345,409,279,94,31,166
53033032208,"Census Tract 322.08, King County, Washington",14000US53033032208,11018171,1305361,8766,8766,2060.581,4.254139788,3575,2877,2665,212,274,0,0,45,24,355,3575,3220,476,579,672,768,456,177,92,355
53033032210,"Census Tract 322.10, King County, Washington",14000US53033032210,41801336,17075,12302,12302,762.2252,16.13958675,6227,4942,3828,1114,608,0,12,204,29,432,6227,5795,263,862,1406,1847,945,299,173,432
53033032211,"Census Tract 322.11, King County, Washington",14000US53033032211,2975633,0,4951,4951,4309.346,1.148898373,2572,2012,1772,240,247,0,0,0,34,279,2572,2293,215,356,521,603,425,162,11,279
53033032212,"Census Tract 322.12, King County, Washington",14000US53033032212,3372134,42596,8608,8608,6611.427,1.301988272,4615,3647,2584,1063,296,0,23,122,37,490,4615,4125,269,646,714,1285,1030,164,17,490
53033032213,"Census Tract 322.13, King County, Washington",14000US53033032213,4137355,286842,4587,4587,2871.466,1.597441764,2251,1820,1618,202,142,0,0,24,0,265,2251,1986,61,302,293,613,512,193,12,265
53033032214,"Census Tract 322.14, King County, Washington",14000US53033032214,6683464,44579,6347,6347,2459.601,2.580499987,2975,2467,1936,531,161,10,8,19,10,300,2975,2675,194,272,508,774,719,131,77,300
53033032215,"Census Tract 322.15, King County, Washington",14000US53033032215,16008606,10175,5276,5276,853.5894,6.180957595,2083,1730,1538,192,85,0,9,0,21,238,2083,1845,48,145,262,659,605,97,29,238
53033032307,"Census Tract 323.07, King County, Washington",14000US53033032307,11666709,234337,6727,6727,1493.382,4.50454172,3481,2945,2710,235,160,0,0,0,13,363,3481,3118,302,627,744,721,545,145,34,363
53033032309,"Census Tract 323.09, King County, Washington",14000US53033032309,6163950,0,6592,6592,2769.847,2.379914502,3662,2702,2335,367,557,0,67,184,19,133,3662,3529,266,1641,688,600,241,73,20,133
53033032311,"Census Tract 323.11, King County, Washington",14000US53033032311,23482239,92771,5898,5898,650.5235,9.066543938,2993,2535,2279,256,47,0,0,79,34,298,2993,2695,58,475,762,633,569,151,47,298
53033032313,"Census Tract 323.13, King County, Washington",14000US53033032313,13092990,436039,6704,6704,1326.151,5.055231916,3426,3072,2468,604,109,0,58,84,15,88,3426,3338,325,1099,949,702,226,36,1,88
53033032315,"Census Tract 323.15, King County, Washington",14000US53033032315,44496824,1355612,5291,5291,307.9686,17.18032053,2626,2235,2052,183,166,0,0,9,33,183,2626,2443,95,461,481,736,377,226,67,183
53033032316,"Census Tract 323.16, King County, Washington",14000US53033032316,6225176,2654247,5769,5769,2400.196,2.403553993,2634,2193,2046,147,103,0,0,6,26,306,2634,2328,38,554,649,455,504,63,65,306
53033032317,"Census Tract 323.17, King County, Washington",14000US53033032317,4393971,0,6303,6303,3715.249,1.69652176,2972,2589,2294,295,83,0,14,88,0,198,2972,2774,268,364,1036,597,378,67,64,198
53033032318,"Census Tract 323.18, King County, Washington",14000US53033032318,7354258,0,5797,5797,2041.56,2.839495009,2986,2525,2122,403,227,0,31,21,0,182,2986,2804,149,388,694,804,608,146,15,182
53033032319,"Census Tract 323.19, King County, Washington",14000US53033032319,6814532,0,5027,5027,1910.604,2.631105627,2608,2282,2139,143,152,0,17,38,22,97,2608,2511,188,759,414,698,205,247,0,97
53033032320,"Census Tract 323.20, King County, Washington",14000US53033032320,9554873,38494,4682,4682,1269.125,3.689157247,2237,1809,1653,156,79,19,37,12,0,281,2237,1956,181,461,446,359,345,113,51,281
53033032321,"Census Tract 323.21, King County, Washington",14000US53033032321,12670960,0,5256,5256,1074.345,4.892285215,2493,2171,1932,239,43,0,9,25,9,236,2493,2257,121,564,787,353,343,80,9,236
53033032322,"Census Tract 323.22, King County, Washington",14000US53033032322,4625052,0,3621,3621,2027.728,1.785742637,1787,1371,1290,81,85,9,22,20,17,263,1787,1524,92,357,476,301,214,66,18,263
53033032323,"Census Tract 323.23, King County, Washington",14000US53033032323,3291842,0,5666,5666,4457.952,1.270987356,2690,2360,1992,368,99,26,23,80,0,102,2690,2588,253,791,639,488,278,139,0,102
53033032324,"Census Tract 323.24, King County, Washington",14000US53033032324,2048401,0,5317,5317,6722.788,0.790892081,3024,2474,2149,325,151,14,56,215,0,114,3024,2910,679,1021,337,411,402,42,18,114
53033032325,"Census Tract 323.25, King County, Washington",14000US53033032325,2212936,0,5114,5114,5985.351,0.854419403,2892,2225,2076,149,288,27,34,137,0,181,2892,2711,250,953,616,460,299,108,25,181
53033032326,"Census Tract 323.26, King County, Washington",14000US53033032326,10460418,0,4272,4272,1057.743,4.038790141,2102,1664,1557,107,127,0,0,36,9,266,2102,1836,134,322,600,368,282,82,48,266
53033032327,"Census Tract 323.27, King County, Washington",14000US53033032327,16127862,106609,3995,3995,641.5607,6.227002596,1359,1138,1053,85,46,9,13,9,0,144,1359,1215,18,181,366,366,206,62,16,144
53033032328,"Census Tract 323.28, King County, Washington",14000US53033032328,8504402,0,3376,3376,1028.15,3.283568109,1660,1344,1240,104,43,10,7,0,19,237,1660,1423,100,260,351,395,226,72,19,237
53033032329,"Census Tract 323.29, King County, Washington",14000US53033032329,9669295,0,8697,8697,2329.552,3.73333583,4319,3835,3221,614,111,0,17,42,96,218,4319,4101,149,637,1500,905,778,50,82,218
53033032401,"Census Tract 324.01, King County, Washington",14000US53033032401,55949550,1058812,5733,5733,265.3891,21.60224372,2695,2513,2267,246,72,0,11,11,0,88,2695,2607,255,130,492,698,764,186,82,88
53033032402,"Census Tract 324.02, King County, Washington",14000US53033032402,25135349,635969,6377,6377,657.0967,9.704812532,3485,3037,2734,303,127,44,0,0,0,277,3485,3208,189,198,520,868,1057,328,48,277
53033032500,"Census Tract 325, King County, Washington",14000US53033032500,213917141,3892704,5399,5399,65.36805,82.59387148,2961,2539,2127,412,65,13,18,47,30,249,2961,2712,206,196,583,621,679,373,54,249
53033032601,"Census Tract 326.01, King County, Washington",14000US53033032601,61321771,1099683,2624,2624,110.8273,23.67646954,1316,1125,1018,107,22,0,11,46,0,112,1316,1204,132,275,161,229,309,74,24,112
53033032602,"Census Tract 326.02, King County, Washington",14000US53033032602,30181212,645284,12602,12602,1081.435,11.6530316,6011,4824,4211,613,298,0,14,127,37,711,6011,5300,520,820,852,1027,1452,534,95,711
53033032702,"Census Tract 327.02, King County, Washington",14000US53033032702,510945718,12517232,6775,6775,34.34253,197.2772569,3789,3213,2696,517,68,0,0,19,96,393,3789,3396,195,528,655,848,814,308,48,393
53033032703,"Census Tract 327.03, King County, Washington",14000US53033032703,10319396,175463,2262,2262,567.7225,3.98434124,1249,1048,947,101,32,7,9,33,16,104,1249,1145,241,238,174,228,153,104,7,104
53033032704,"Census Tract 327.04, King County, Washington",14000US53033032704,17160818,447183,6535,6535,986.2916,6.625829154,3197,2786,2420,366,40,12,12,72,36,239,3197,2958,471,709,504,504,674,69,27,239
53033032800,"Census Tract 328, King County, Washington",14000US53033032800,1390296741,27317733,2352,2352,4.381548,536.7965813,1347,1235,1085,150,12,0,15,17,8,60,1347,1287,143,136,170,264,380,143,51,60